111111111
1P0000111
100C001E1
111111111
