111111111
1P0000001
100C001E1
111111111
