1111111111111111111111111111111111111111
11CCCCCCCCCCCCCCCCCCCCCCCCCCCCCCCCCCCCC1
11CCCCCCCCC1111111CCCCCCCCCCCCCCCCCCCCC1
11CCCCCCCC1CCCCCCC11111111111111111111C1
11C1111111CPC1C1CC111CCCCCCCCCCCCCCC11C1
11CCCCCCCCCC1CC1CC111C11111C1111111C11C1
11CCCCCC1111CCC1CC111C11111C1111111C11C1
11111111C0C1111CCC111C11111C1111111C11C1
11CCCCC1C1111CCCC1111CCCCCCCCCCCCCCC11C1
11CCCCC1CC10CC1111111CCCCCCCCCCCCCCC11C1
11CCCCCC1C11111111111CCCCCCCCCCCCCCC11C1
11CCCCCCCCCCCCCCCCCCCCCCCCCCCCCCCCCCCCC1
1111111111111111111111111111111110111111
1111111111111111111111111111111110111111
11CCCCCCCCCCCCCCCCCCCCCCCCCCCCCCCCCCCCC1
11CCCCCCCCC1111111CCCCCCCCCCCCCCCCCCCCC1
11CCCCCCCC1CCCCCCC11111111111111111111C1
11C1111111CCC1C1CC111CCCCCCCCCCCCCCC11C1
11CCCCCCCCCC1CC1CC111C11111C1111111C11C1
11CCCCCC1111CCC1CC111C11111C1111111C11C1
11111111C0C1111CCC111C11111C1111111C11C1
11CCCCC1C1111CCCC1111CCCCCCCCCCCCCCC11C1
11CCCCC1CC10CC1111111CCCCCCCCCCCCCCC11C1
11CCCCCC1C11111111111CCCCCCCCCCCCCCC11C1
11CCCCCCCCCCCCCCCCCCCCCCCCCCCCCCCCCCCCC1
1111111111111111111111111111111110111111
1111111111111111111111111111111110111111
11CCCCCCCCCCCCCCCCCCCCCCCCCCCCCCCCCCCCC1
11CCCCCCCCC1111111CCCCCCCCCCCCCCCCCCCCC1
11CCCCCCCC1CCCCCCC11111111111111111111C1
11C1111111CCC1C1CC111CCCCCCCCCCCCCCC11C1
11CCCCCCCCCC1CC1CC111C11111C1111111C11C1
11CCCCCC1111CCC1CC111C11111C1111111C11C1
11111111C0C1111CCC111C11111C1111111C11C1
11CCCCC1C1111CCCC1111CCCCCCCCCCCCCCC11C1
11CCCCC1CC10CC1111111CCCCCCCCCCCCCCC11C1
11CCCCCC1C11111111111CCCCCCCCCCCCCCC11C1
11CCCCCCCCCCCCCCCCCCCCCCCCCCCCCCCCCCCCC1
1111111111111111111111111111111110111111
1111111111111111111111111111111110111111
11CCCCCCCCCCCCCCCCCCCCCCCCCCCCCCCCCCCCC1
11CCCCCCCCC1111111CCCCCCCCCCCCCCCCCCCCC1
11CCCCCCCC1CCCCCCC11111111111111111111C1
11C1111111CCC1C1CC111CCCCCCCCCCCCCCC11C1
11CCCCCCCCCC1CC1CC111C11111C1111111C11C1
11CCCCCC1111CCC1CC111C11111C1111111C11C1
11111111C0C1111CCC111C11111C1111111C11C1
11CCCCC1C1111CCCC1111CCCCCCCCCCCCCCC11C1
11CCCCC1CC10CC1111111CCCCCCCCCCCCCCC11C1
11CCCCCC1C11111111111CCCCCCCCCCCCCCC11C1
11CCCCCCCCCCCCCCCCCCCCCCCCCCCCCCCCCCCCC1
1111111111111111111111111111111110111111
1111111111111111111111111111111110111111
11CCCCCCCCCCCCCCCCCCCCCCCCCCCCCCCCCCCCC1
11CCCCCCCCC1111111CCCCCCCCCCCCCCCCCCCCC1
11CCCCCCCC1CCCCCCC11111111111111111111C1
11C1111111CCC1C1CC111CCCCCCCCCCCCCCC11C1
11CCCCCCCCCC1CC1CC111C11111C1111111C11C1
11CCCCCC1111CCC1CC111C11111C1111111C11C1
11111111C0C1111CCC111C11111C1111111C11C1
11CCCCC1C1111CCCC1111CCCCCCCCCCCCCCC11C1
11CCCCC1CC10CC1111111CCCCCCCCCCCCCCC11C1
11CCCCCC1C11111111111CCCCCCCCCCCCCCC11C1
11CCCCCCCCCCCCCCCCCCCCCCCCCCCCCCCCCCCCC1
1111111111111111111111111111111110111111
1111111111111111111111111111111110111111
11CCCCCCCCCCCCCCCCCCCCCCCCCCCCCCCCCCCCC1
11CCCCCCCCC1111111CCCCCCCCCCCCCCCCCCCCC1
11CCCCCCCC1CCCCCCC11111111111111111111C1
11C1111111CCC1C1CC111CCCCCCCCCCCCCCC11C1
11CCCCCCCCCC1CC1CC111C11111C1111111C11C1
11CCCCCC1111CCC1CC111C11111C1111111C11C1
11111111C0C1111CCC111C11111C1111111C11C1
11CCCCC1C1111CCCC1111CCCCCCCCCCCCCCC11C1
11CCCCC1CC10CC1111111CCCCCCCCCCCCCCC11C1
11CCCCCC1C11111111111CCCCCCCCCCCCCCC11C1
11CCCCCCCCCCCCCCCCCCCCCCCCCCCCCCCCCCCCC1
1111111111111111111111111111111110111111
1111111111111111111111111111111110111111
11CCCCCCCCCCCCCCCCCCCCCCCCCCCCCCCCCCCCC1
11CCCCCCCCC1111111CCCCCCCCCCCCCCCCCCCCC1
11CCCCCCCC1CCCCCCC11111111111111111111C1
11C1111111CCC1C1CC111CCCCCCCCCCCCCCC11C1
11CCCCCCCCCC1CC1CC111C11111C1111111C11C1
11CCCCCC1111CCC1CC111C11111C1111111C11C1
11111111C0C1111CCC111C11111C1111111C11C1
11CCCCC1C1111CCCC1111CCCCCCCCCCCCCCC11C1
11CCCCC1CC10CC1111111CCCCCCCCCCCCCCC11C1
11CCCCCC1C11111111111CCCCCCCCCCCCCCC11C1
11CCCCCCCCCCCCCCCCCCCCCCCCCCCCCCCCCCCCC1
1111111111111111111111111111111110111111
1111111111111111111111111111111110111111
11CCCCCCCCCCCCCCCCCCCCCCCCCCCCCCCCCCCCC1
11CCCCCCCCC1111111CCCCCCCCCCCCCCCCCCCCC1
11CCCCCCCC1CCCCCCC11111111111111111111C1
11C1111111CCC1C1CC111CCCCCCCCCCCCCCC11C1
11CCCCCCCCCC1CC1CC111C11111C1111111C11C1
11CCCCCC1111CCC1CC111C11111C1111111C11C1
11111111CEC1111CCC111C11111C1111111C11C1
11CCCCC1C1111CCCC1111CCCCCCCCCCCCCCC11C1
11CCCCC1CC1CCC1111111CCCCCCCCCCCCCCC11C1
11CCCCCC1C11111111111CCCCCCCCCCCCCCC11C1
11CCCCCCCCCCCCCCCCCCCCCCCCCCCCCCCCCCCCC1
1111111111111111111111111111111111111111
