111111111111111111
1P0000001100C000C1
100C001C1100C001C1
100C001CCC00C001C1
100C001C1100C001C1
100C001C0000C001C1
100C001C1100C001C1
100C001CCC00C001E1
111111111111111111