1111111111111111111111111111111111111111
1P00CCC000000000000001111100000000000001
10100000000000000000000000000000000CCC01
10000000000000000000000C0000000000000011
10100000C0000001111111100000000000000001
1000001111000000000000000000000000000011
1010000000000000011111000C00000000000001
100000000000C000000000000000000000000011
100CCCCCCCCCCCCCCCCCCCCCCCCCCCECCCCCC101
1111111111111111111111111111111111111111