111111111111111111
1P0000001100C000C1
100C001C1100C001C1
1000001CCC00C001C1
1000001011000001C1
1000001000000001C1
1000001011000001C1
1000001000000001E1
111111111111111111