111111111
1P0100001
11CC001E1
111111111